#########
##.....##
##o##..##
##.##.*.#
#.*..**.#
#.ooo.#.#
#..####.#
#.A.....#
#########