#########
##     ##
##.##  ##
## ## $ #
# $  $$ #
# ... # #
#  #### #
# @     #
#########

#######
##    #
##$ . #
#  @  #
# $#. #
#  ####
#######