#########
##.....##
##.##..##
##.##.*.#
#.......#
#..o..#.#
#..####.#
#.A.....#
#########