##########
#ooo.....#
#...***..#
#.......A#
##########