########
#..o.o.#
#....#.#
##.#.#.#
 #..*..#
 #..*A.#
 #.....#
 #######