#######
##....#
##*.o.#
#..A..#
#..#..#
#..####
#######