#####
#o..#
#.*.#
#o*A#
#####
