#######
#.o...#
#.#.#.#
#.#.#.#
#.*A..#
#.....#
#######