#########
##.....##
##.##..##
##.##.*.#
#.....*.#
#.o@o.#.#
#..####.#
#.A.....#
#########