####
#..#########
#....##....#
#.***#.....#
##ooo#.#***#
 #ooo#.#ooo#
 #***..#ooo##
 #....##***.#
 #######.A..#
       ######