##################
#o*A.............#
#................#
#................#
#................#
#................#
#######...########
#................#
#................#
#................#
##################