####
#.o#
#..###
#@*..#
#..A.#
#....#
######