##################
#ooo.............#
#................#
#................#
#................#
#.....***........#
#................#
#................#
#................#
#...............A#
##################